000000000000000000000000000000000000000000000000000000000000
000000000000000000000000000322222222222222222222222222222230
032222222222222230000000000231111111111111111111111111111320
023111111111111320000000000210000000000000000000000000000120
021000000000000120000000000210000000000000000000000000000120
021000000000000120000000000210000000000000000000000000000120
021000000000000120000000000210000000000000000000000000000120
021000000000000120000000000210000000000000000000000000000120
021000000000000120000000000210000000000000000000000000000120
021000000000000120000000000210000000000000000000000000000120
021000000000000120000000000210000000000000000000000000000120
021000000000000120000000000210000000000000000000000000000120
021000000000000120000000000210000000032222223000000000000120
021000000000000120000000000210000000023111132000000000000120
021000000000000120000000000210000000021000012000000000000120
021000000000000120000000000210000000021000012000000000000120
021000000000000120000000000210000000021000012000000000000120
021000000000000120000000000210000000021000012000000000000120
021000000000000120000000000210000000021000012000000000000120
021000000000000120000000000210000000021000012000000000000120
021000000000000120000000000210000000021000012000000000000120
021000000000000120000000000410000000021000012000000000000120
021000000000000132222222222554222222231000012000000000000120
021000000000000311111111114551111111113000012000000000000120
021000000000000000000000000240000000000000012000000000000120
021000000000000000000000000210000000000000013222223000000120
021000000000000000000000000210000000000000013211132000000120
021000000000000000000000000210000000000000012000012000000120
021000000000000000000000000210000000000000012000012000000120
021000000000000003222222222310000000000000012000012000000120
021000000000000002311111112310000000000000012000012000000120
021000000000000002100000000210000000000000012000012000000120
021000000000000002100000000210000000000000012000012000000120
021000000000000002100000000210000000000000012000012000000120
021000000000000002100000000231111111111111132000012000000120
021000000000000002100000000322222222222222223000012000000120
021000000000000002100000000000000000000000000000012000000120
021000000000000002100000000000000000000000021111132000001200
021000000000000002100000000000000000000000013222223000001200
021000000000000002100000000000000000000000012000000000000120
021000000000000002100000000000000000000000012000000000000120
021000000000000002100000000000000000000000012000000000000120
021000000000000002100000000000000000000000042000000000000120
021000000000000002311111111111111111111111155411111111111320
021000000000000003222222222222222222222222455222222222222230
021000000000000000000000000000000000000000014000000000000000
021000000000000000000000000000000000000000012000000000000000
021000000000000000000000000000000000000000012000000000000000
021000000000000000000000000000000000000000012000000000000000
021000000000000000000000000000000000000000012000000000000000
021000000000000000000000000000000000000000012000000000000000
021000000000000000000000000000000000000000012000000000000000
021000000000000000000000000000000000000000012000000000000000
021000000000000000000000000000000000000000012000000000000000
023111111111111111111111111111111111111111132000000000000000
032222222222222222222222222222222222222222223000000000000000
000000000000000000000000000000000000000000000000000000000000