000000000000000000000000000002222222222222222222222222222000
000222222222222000000000000031111111111111111111111111111300
003111111111111300000000000210000000000000000000000000000120
021000000000000120000000000210000000000000000000000000000120
021000000000000120000000000210000000000000000000000000000120
021000000000000120000000000210000000000000000000000000000120
021000000000000120000000000210000000000000000000000000000120
021000000000000120000000000210000000000000000000000000000120
021000000000000120000000000210000000000000000000000000000120
021000000000000120000000000210000000000000000000000000000120
021000000000000120000000000210000000000000000000000000000120
021000000000000120000000000210000000000222200000000000000120
021000000000000120000000000210000000003111130000000000000120
021000000000000120000000000210000000021000012000000000000120
021000000000000120000000000210000000021000012000000000000120
021000000000000120000000000210000000021000012000000000000120
021000000000000120000000000210000000021000012000000000000120
021000000000000120000000000210000000021000012000000000000120
021000000000000120000000000210000000021000012000000000000120
021000000000000120000000000210000000021000012000000000000120
021000000000000120000000000210000000021000012000000000000120
021000000000000132222222222442222222230000012000000000000120
021000000000000011111111111441111111100000012000000000000120
021000000000000000000000000210000000000000012000000000000120
021000000000000000000000000210000000000000012322200000000120
021000000000000000000000000210000000000000012311130000000120
021000000000000000000000000210000000000000012000012000000120
021000000000000000000000000210000000000000012000012000000120
021000000000000000022222223210000000000000012000012000000120
021000000000000000311111113210000000000000012000012000000120
021000000000000002100000000210000000000000012000012000000120
021000000000000002100000000210000000000000012000012000000120
021000000000000002100000000210000000000000012000012000000120
021000000000000002100000000210000000000000012000012000000120
021000000000000002100000000231111111111111132000012000000120
021000000000000002100000000322222222222222223000012000000120
021000000000000002100000000000000000000000000111130000000120
021000000000000002100000000000000000000000003222200000000120
021000000000000002100000000000000000000000012000000000000120
021000000000000002100000000000000000000000012000000000000120
021000000000000002100000000000000000000000012000000000000120
021000000000000002100000000000000000000000012000000000000120
021000000000000000311111111111111111111111144111111111111300
021000000000000000022222222222222222222222244222222222222000
021000000000000000000000000000000000000000012000000000000000
021000000000000000000000000000000000000000012000000000000000
021000000000000000000000000000000000000000012000000000000000
021000000000000000000000000000000000000000012000000000000000
021000000000000000000000000000000000000000012000000000000000
021000000000000000000000000000000000000000012000000000000000
021000000000000000000000000000000000000000012000000000000000
021000000000000000000000000000000000000000012000000000000000
021000000000000000000000000000000000000000012000000000000000
003111111111111111111111111111111111111111130000000000000000
000222222222222222222222222222222222222222200000000000000000
000000000000000000000000000000000000000000000000000000000000